BordererMap
11
20
WWWWWWWWWWWWWWWWWWWW
W--R------------L--W
W------------------W
W------------------W
W------------------W
W--R------------L--W
W------------------W
W------------------W
W------------------W
W--R------------L--W
WWWWWWWWWWWWWWWWWWWW