BridgeLevel
11
20
--------------------
---R------------L---
--------------------
-----WWWWWWWWWW-----
--------------------
---R------------L---
--------------------
-----WWWWWWWWWW-----
--------------------
---R------------L---
--------------------