XMap
15
20
WWWWWWW------WWWWWWW
W-----w------w-----W
W-----w------w-----W
W--D--wwwwwwww--D--W
W------------------W
W------------------W
--------------------
--------------------
--------------------
W------------------W
W------------------W
W--U--w------w--U--W
W-----w------w-----W
W-----w------w-----W
WWWWWWW------WWWWWWW