XMap
15
20
WWWWWWW------WWWWWWW
W-----W------W-----W
W-----W------W-----W
W--D--WWWWWWWW--D--W
W------------------W
W------------------W
--------------------
--------------------
--------------------
W------------------W
W------------------W
W--U--W------W--U--W
W-----W------W-----W
W-----W------W-----W
WWWWWWW------WWWWWWW